.......................
.SPPP..PPP.PPP.PPP.PPP.
----PPPP.PPP.PPP.PPP.P.
-------..............P.
.PPPPPPPPPPPPPPPPPPPPP.
.P.....-----------...--
.PPPP................--
....PPPPPPPPPPPPPPPP.--
---......----......P.--
---.PPPPPPPPPPPPPPPP.--
---.P................--
---.P..----------------
---.P..............----
---.PPPPPPPPPPPPF..----
---................----