..................
.SPPPPPPPPPPPPPPP.
................P.
....PPPPPPPPP...P.
.PPPP.......PPPPP.
.P................
.P..PPPPPPPPPPPPP.
.P..P...........P.
.P..P....PPPF...P.
.P..P....P......P.
.P..P....P......P.
.PPPP....PPPPPPPP.
..................
#
16 1
16 4
13 4
13 3
4 3
4 4
1 4
1 11
4 11
4 6
16 6
16 16
11 16
11 9
12 8